


































########
#       #####
#                   ###
#                   ###
#                               #
#                               #
#                               #
#                               #
#                               #
#                   ###
#                   ###
###       ###










##########
#       #                   ##
#                                     ##
#                   #####
#                   #####
#       #                         #
## #                         #
#                                           #
#                                      ##
####       ####
